3
82
40
32
32
tileFond.png
58 59 60 61 62 63 64 65 66 58 58 59 60 61 62 63 64 65 66 67 68 80 81 82 83 84 85 58 59 60 58 59 60 61 62 63 64 65 66 67 68 58 59 60 61 62 63 64 65 66 58 58 59 60 61 62 63 64 65 66 67 68 80 81 82 83 84 85 58 59 60 58 59 60 61 62 63 64 65 66 67 68
77 78 79 80 81 82 83 84 85 77 77 78 79 80 81 82 83 84 85 86 87 99 100 101 102 103 104 77 78 79 77 78 79 80 81 82 83 84 85 86 87 77 78 79 80 81 82 83 84 85 77 77 78 79 80 81 82 83 84 85 86 87 99 100 101 102 103 104 77 78 79 77 78 79 80 81 82 83 84 85 86 87 
96 97 98 99 100 101 102 103 104 96 96 97 98 99 100 101 102 103 104 105 106 118 119 120 121 122 123 96 97 98 96 97 98 99 100 101 102 103 104 105 106 96 97 98 99 100 101 102 103 104 96 96 97 98 99 100 101 102 103 104 105 106 118 119 120 121 122 123 96 97 98 96 97 98 99 100 101 102 103 104 105 106  
115 116 117 118 119 120 121 122 123 115 115 116 117 118 119 120 121 122 123 124 125 137 138 139 140 141 142 115 116 117 115 116 117 118 119 120 121 122 123 124 125 115 116 117 118 119 120 121 122 123 115 115 116 117 118 119 120 121 122 123 124 125 137 138 139 140 141 142 115 116 117 115 116 117 118 119 120 121 122 123 124 125 
134 135 136 137 138 139 140 141 142 134 134 135 136 137 138 139 140 141 142 143 144 156 157 158 159 160 161 134 135 136 134 135 136 137 138 139 140 141 142 143 144 134 135 136 137 138 139 140 141 142 134 134 135 136 137 138 139 140 141 142 143 144 156 157 158 159 160 161 134 135 136 134 135 136 137 138 139 140 141 142 143 144
153 154 155 156 157 158 159 160 161 153 153 154 155 156 157 158 159 160 161 162 163 175 176 177 178 179 180 153 154 155 153 154 155 156 157 158 159 160 161 162 163 153 154 155 156 157 158 159 160 161 153 153 154 155 156 157 158 159 160 161 162 163 175 176 177 178 179 180 153 154 155 153 154 155 156 157 158 159 160 161 162 163
172 173 174 175 176 177 178 179 180 172 172 173 174 175 176 177 178 179 180 181 182 194 195 196 197 198 199 172 173 174 172 173 174 175 176 177 178 179 180 181 182 172 173 174 175 176 177 178 179 180 172 172 173 174 175 176 177 178 179 180 181 182 194 195 196 197 198 199 172 173 174 172 173 174 175 176 177 178 179 180 181 182
191 192 193 194 195 196 197 198 199 191 191 192 193 194 195 196 197 198 199 200 201 213 214 215 216 217 218 191 192 193 191 192 193 194 195 196 197 198 199 200 201 191 192 193 194 195 196 197 198 199 191 191 192 193 194 195 196 197 198 199 200 201 213 214 215 216 217 218 191 192 193 191 192 193 194 195 196 197 198 199 200 201
210 211 212 213 214 215 216 217 218 210 210 211 212 213 214 215 216 217 218 219 220 215 216 217 218 219 220 210 211 212 210 211 212 213 214 215 216 217 218 219 220 210 211 212 213 214 215 216 217 218 210 210 211 212 213 214 215 216 217 218 219 220 215 216 217 218 219 220 210 211 212 210 211 212 213 214 215 216 217 218 219 220
58 59 60 61 62 63 64 65 66 58 59 1 1 1 1 1 1 1 1 1 1 1 1 1 1 1 1 1 1 1 1 1 1 1 1 1 1 1 1 1 1 1 1 1 1 1 1 1 1 1 1 1 1 1 1 1 1 1 1 1 1 1 1 1 1 1 1 1 1 1 1 58 59 60 61 62 63 64 65 66 58 59
77 78 79 80 81 82 83 84 85 77 78 1 1 1 1 1 1 1 1 1 1 1 1 1 1 1 1 1 1 1 1 1 1 1 1 1 1 1 1 1 1 1 1 1 1 1 1 1 1 1 1 1 1 1 1 1 1 1 1 1 1 1 1 1 1 1 1 1 1 1 1 77 78 79 80 81 82 83 84 85 77 78
96 97 98 99 100 101 102 103 104 96 97 1 1 1 1 1 1 1 1 1 1 1 1 1 1 1 1 1 1 1 1 1 1 1 1 1 1 1 1 1 1 1 1 1 1 1 1 1 1 1 1 1 1 1 1 1 1 1 1 1 1 1 1 1 1 1 1 1 1 1 1 96 97 98 99 100 101 102 103 104 96 97
115 116 117 118 119 120 121 122 123 115 116 1 1 1 1 1 1 1 1 1 1 1 1 1 1 1 1 1 1 1 1 1 1 1 1 1 1 1 1 1 1 1 1 1 1 1 1 1 1 1 1 1 1 1 1 1 1 1 1 1 1 1 1 1 1 1 1 1 1 1 1 115 116 117 118 119 120 121 122 123 115 116
134 135 136 137 138 139 140 141 142 134 135 1 1 1 1 1 1 1 1 1 1 1 1 1 1 1 1 1 1 1 1 1 1 1 1 1 1 1 1 1 1 1 1 1 1 1 1 1 1 1 1 1 1 1 1 1 1 1 1 1 1 1 1 1 1 1 1 1 1 1 1 134 135 136 137 138 139 140 141 142 134 135
153 154 155 156 157 158 159 160 161 153 154 1 1 1 1 1 1 1 1 1 1 1 1 1 1 1 1 1 1 1 1 1 1 1 1 1 1 1 1 1 1 1 1 1 1 1 1 1 1 1 1 1 1 1 1 1 1 1 1 1 1 1 1 1 1 1 1 1 1 1 1 153 154 155 156 157 158 159 160 161 153 154
172 173 174 175 176 177 178 179 180 172 173 1 1 1 1 1 1 1 1 1 1 1 1 1 1 1 1 1 1 1 1 1 1 1 1 1 1 1 1 1 1 1 1 1 1 1 1 1 1 1 1 1 1 1 1 1 1 1 1 1 1 1 1 1 1 1 1 1 1 1 1 172 173 174 175 176 177 178 179 180 172 173
191 192 193 194 195 196 197 198 199 191 192 1 1 1 1 1 1 1 1 1 1 1 1 1 1 1 1 1 1 1 1 1 1 1 1 1 1 1 1 1 1 1 1 1 1 1 1 1 1 1 1 1 1 1 1 1 1 1 1 1 1 1 1 1 1 1 1 1 1 1 1 191 192 193 194 195 196 197 198 199 191 192
210 211 212 213 214 215 216 217 218 210 211 1 1 1 1 1 1 1 1 1 1 1 1 1 1 1 1 1 1 1 1 1 1 1 1 1 1 1 1 1 1 1 1 1 1 1 1 1 1 1 1 1 1 1 1 1 1 1 1 1 1 1 1 1 1 1 1 1 1 1 1 210 211 212 213 214 215 216 217 218 210 211
58 59 60 61 62 63 64 65 66 58 59 60 61 62 63 64 65 66 67 68 80 81 82 83 84 85 58 59 60 58 59 60 61 62 63 64 65 66 67 68 58 59 60 1 1 1 1 1 1 1 1 1 1 1 1 1 1 1 1 1 1 1 1 1 1 1 1 1 1 1 1 58 59 60 61 62 63 64 65 66 58 59
77 78 79 80 81 82 83 84 85 77 78 60 61 62 63 64 65 66 67 68 80 81 82 83 84 85 58 59 60 58 59 60 61 62 63 64 65 66 67 68 58 59 60 1 1 1 1 1 1 1 1 1 1 1 1 1 1 1 1 1 1 1 1 1 1 1 1 1 1 1 1 77 78 79 80 81 82 83 84 85 77 78
96 97 98 99 100 101 102 103 104 96 97 60 61 62 63 64 65 66 67 68 80 81 82 83 84 85 58 59 60 58 59 60 61 62 63 64 65 66 67 68 58 59 60 1 1 1 1 1 1 1 1 1 1 1 1 1 1 1 1 1 1 1 1 1 1 1 1 1 1 1 1 96 97 98 99 100 101 102 103 104 96 97
115 116 117 118 119 120 121 122 123 115 116 59 60 61 62 63 64 65 66 67 68 80 81 82 83 84 85 58 59 60 58 59 60 61 62 63 64 65 66 67 68 58 59 1 1 1 1 1 1 1 1 1 1 1 1 1 1 1 1 1 1 1 1 1 1 1 1 1 1 1 1 115 116 117 118 118 119 120 121 122 123 115 116
134 135 136 137 138 139 140 141 142 134 135 59 60 61 62 63 64 65 66 67 68 80 81 82 83 84 85 58 59 60 58 59 60 61 62 63 64 65 66 67 68 58 1 1 1 1 1 1 1 1 1 1 1 1 1 1 1 1 1 1 1 1 1 1 1 1 1 1 1 1 134 135 136 137 138 139 140 141 142 134 135
77 78 79 80 81 82 83 84 85 77 78 1 1 1 1 1 1 1 1 1 1 1 1 1 1 1 1 1 1 1 1 1 1 1 1 1 1 1 1 1 1 1 1 1 1 1 1 1 1 1 1 1 1 1 1 1 1 1 1 1 1 1 1 1 1 1 1 1 1 1 1 77 78 79 80 81 82 83 84 85 77 78
96 97 98 99 100 101 102 103 104 96 97 1 1 1 1 1 1 1 1 1 1 1 1 1 1 1 1 1 1 1 1 1 1 1 1 1 1 1 1 1 1 1 1 1 1 1 1 1 1 1 1 1 1 1 1 1 1 1 1 1 1 1 1 1 1 1 1 1 1 1 1 96 97 98 99 100 101 102 103 104 96 97
115 116 117 118 119 120 121 122 123 115 116 1 1 1 1 1 1 1 1 1 1 1 1 1 1 1 1 1 1 1 1 1 1 1 1 1 1 1 1 1 1 1 1 1 1 1 1 1 1 1 1 1 1 1 1 1 1 1 1 1 1 1 1 1 1 1 1 1 1 1 1 115 116 117 118 119 120 121 122 123 115 116
134 135 136 137 138 139 140 141 142 134 135 1 1 1 1 1 1 1 1 1 1 1 1 1 1 1 1 1 1 1 1 1 1 1 1 1 1 1 1 1 1 1 1 1 1 1 1 1 1 1 1 1 1 1 1 1 1 1 1 1 1 1 1 1 1 1 1 1 1 1 1 134 135 136 137 138 139 140 141 142 134 135
153 154 155 156 157 158 159 160 161 153 154 1 1 1 1 1 1 1 1 1 1 1 1 1 1 1 1 1 1 1 1 1 1 1 1 1 1 1 1 1 1 1 1 1 1 1 1 1 1 1 1 1 1 1 1 1 1 1 1 1 1 1 1 1 1 1 1 1 1 1 1 153 154 155 156 157 158 159 160 161 153 154
172 173 174 175 176 177 178 179 180 172 173 1 1 1 1 1 1 1 1 1 1 1 1 1 1 1 1 1 1 1 1 1 1 1 1 1 1 1 1 1 1 1 1 1 1 1 1 1 1 1 1 1 1 1 1 1 1 1 1 1 1 1 1 1 1 1 1 1 1 1 1 172 173 174 175 176 177 178 179 180 172 173
191 192 193 194 195 196 197 198 199 191 192 1 1 1 1 1 1 1 1 1 1 1 1 1 1 1 1 1 1 1 1 1 1 1 1 1 1 1 1 1 1 1 1 1 1 1 1 1 1 1 1 1 1 1 1 1 1 1 1 1 1 1 1 1 1 1 1 1 1 1 1 191 192 193 194 195 196 197 198 199 191 192
210 211 212 213 214 215 216 217 218 210 211 1 1 1 1 1 1 1 1 1 1 1 1 1 1 1 1 1 1 1 1 1 1 1 1 1 1 1 1 1 1 1 1 1 1 1 1 1 1 1 1 1 1 1 1 1 1 1 1 1 1 1 1 1 1 1 1 1 1 1 1 210 211 212 213 214 215 216 217 218 210 211
58 59 60 61 62 63 64 65 66 58 58 59 60 61 62 63 64 65 66 67 68 80 81 82 83 84 85 58 59 60 58 59 60 61 62 63 64 65 66 67 68 58 59 60 61 62 63 64 65 66 58 58 59 60 61 62 63 64 65 66 67 68 80 81 82 83 84 85 58 59 60 58 59 60 61 62 63 64 65 66 67 68
77 78 79 80 81 82 83 84 85 77 77 78 79 80 81 82 83 84 85 86 87 99 100 101 102 103 104 77 78 79 77 78 79 80 81 82 83 84 85 86 87 77 78 79 80 81 82 83 84 85 77 77 78 79 80 81 82 83 84 85 86 87 99 100 101 102 103 104 77 78 79 77 78 79 80 81 82 83 84 85 86 87 
96 97 98 99 100 101 102 103 104 96 96 97 98 99 100 101 102 103 104 105 106 118 119 120 121 122 123 96 97 98 96 97 98 99 100 101 102 103 104 105 106 96 97 98 99 100 101 102 103 104 96 96 97 98 99 100 101 102 103 104 105 106 118 119 120 121 122 123 96 97 98 96 97 98 99 100 101 102 103 104 105 106  
115 116 117 118 119 120 121 122 123 115 115 116 117 118 119 120 121 122 123 124 125 137 138 139 140 141 142 115 116 117 115 116 117 118 119 120 121 122 123 124 125 115 116 117 118 119 120 121 122 123 115 115 116 117 118 119 120 121 122 123 124 125 137 138 139 140 141 142 115 116 117 115 116 117 118 119 120 121 122 123 124 125 
134 135 136 137 138 139 140 141 142 134 134 135 136 137 138 139 140 141 142 143 144 156 157 158 159 160 161 134 135 136 134 135 136 137 138 139 140 141 142 143 144 134 135 136 137 138 139 140 141 142 134 134 135 136 137 138 139 140 141 142 143 144 156 157 158 159 160 161 134 135 136 134 135 136 137 138 139 140 141 142 143 144
153 154 155 156 157 158 159 160 161 153 153 154 155 156 157 158 159 160 161 162 163 175 176 177 178 179 180 153 154 155 153 154 155 156 157 158 159 160 161 162 163 153 154 155 156 157 158 159 160 161 153 153 154 155 156 157 158 159 160 161 162 163 175 176 177 178 179 180 153 154 155 153 154 155 156 157 158 159 160 161 162 163
172 173 174 175 176 177 178 179 180 172 172 173 174 175 176 177 178 179 180 181 182 194 195 196 197 198 199 172 173 174 172 173 174 175 176 177 178 179 180 181 182 172 173 174 175 176 177 178 179 180 172 172 173 174 175 176 177 178 179 180 181 182 194 195 196 197 198 199 172 173 174 172 173 174 175 176 177 178 179 180 181 182
191 192 193 194 195 196 197 198 199 191 191 192 193 194 195 196 197 198 199 200 201 213 214 215 216 217 218 191 192 193 191 192 193 194 195 196 197 198 199 200 201 191 192 193 194 195 196 197 198 199 191 191 192 193 194 195 196 197 198 199 200 201 213 214 215 216 217 218 191 192 193 191 192 193 194 195 196 197 198 199 200 201
210 211 212 213 214 215 216 217 218 210 210 211 212 213 214 215 216 217 218 219 220 215 216 217 218 219 220 210 211 212 210 211 212 213 214 215 216 217 218 219 220 210 211 212 213 214 215 216 217 218 210 210 211 212 213 214 215 216 217 218 219 220 215 216 217 218 219 220 210 211 212 210 211 212 213 214 215 216 217 218 219 220